111111111111111111111111111111
111111111111111111111111100011
11000111111000111100C11110C011
110C0111110C000110C00111100011
1100001111000C01100C0111110001
11000011100C000110000111110001
111000011000000000001111000011
1110C00000111111100011110C0111
110000011111111111000111100011
110001111111110111110001100001
111001111111100011110C01110001
11100111111100E001110001110C01
1110C011111100P001110011110001
111000011111100011100011100011
111000000111100111000000000111
1100C01100000000000000000C0011
110000111000011100C00111000111
111111111111111110001111111111
111111111111111111111111111111